1 1 1 1 1 1 1 1 1 1
1 5 5 5 1 2 2 1 1 1
1 # # 1 1 2 9 9 1 1
1 1 1 1 # 1 1 1 1 1
S 1 1 2 1 1 1 1 1 G
